abduzir – sinônimo de afastar, arrebatar e raptar
acrimônia – sinônimo de azedume e mordacidade
adstrito – sinônimo de unido, ligado e apertado
belicoso – sinônimo de agressivo, guerreiro e armífero
capcioso – sinônimo de enganoso, manhoso e ardiloso
chistoso – sinônimo de brincalhão, engraçado e divertido
coalizão – sinônimo de aliança e coligação
cominar – sinônimo de ameaçar (com um castigo)
consociação – sinônimo de conciliação e associação
corolário – sinônimo de resultado, conclusão e consequência
dissentir – sinônimo de discordar e discrepar
eflúvio – sinônimo de perfume e aroma
elucubrações – sinônimo de conjectura, consideração e especulação
empedernido – sinônimo de petrificado, duro e inflexível
engodar – sinônimo de enganar e iludir
exórdio – sinônimo de prólogo e preâmbulo
homizio – sinônimo de esconderijo e valhacouto
idiossincrasia – sinônimo de característica e particularidade
ígneo – sinônimo de ardente e inflamado
influição – sinônimo de influência e influxo
jaez – sinônimo de espécie, tipo e qualidade
lauto – sinônimo de abundante e suntuoso
loquaz – sinônimo de tagarela e falador
mediatário – sinônimo de mediador
opróbrio – sinônimo de vergonha, ofensa e insulto
oscular – sinônimo de beijar
pecúlio – sinônimo de dinheiro, economia e patrimônio
perdulário – sinônimo de esbanjador e gastador
pernóstico – sinônimo de pretensioso, esnobe e afetado
plaga – sinônimo de região e país
procrastinar – sinônimo de adiar e postergar
prolegômenos – sinônimo de princípios e rudimentos
quimera – sinônimo de fantasia, utopia e ilusão
rubicundo – sinônimo de avermelhado e corado
tergiversar – sinônimo de hesitar (com desculpas e rodeios)
ufanismo – sinônimo de nacionalismo e patriotismo
vicissitudes – sinônimo de eventualidade e contingência
vitupério – sinônimo de afronta, injúria e ultraje